R 720   480

NO ./texture/n_wall_pixel.xpm
SO ./texture/s_wall_pixel.xpm
EA ./texture/e_wall_pixel.xpm
WE ./texture/w_wall_pixel.xpm
S ./texture/barrel.xpm

C 120 ,  200,200


F 45 ,  50,30

        1111111111111111111111111
        1000000000110000000000001
        1011000001110000002000001
        1001000000000000000000001
111111111011000001110000000000001
100000000011000001110111111111111
11110111111111011100000000001
11110111111111011101010010001
11200000110101011100000010001
10002W00000000001100000010001
10000000000000001101010010001
1100000111010101111101111000111
11110111 1110101 101111010001
11111111 1111111 111111111111