R 720   480

NO ./texture/wall.xpm
SO ./texture/wall.xpm
EA ./texture/wall.xpm
WE ./texture/wall.xpm
S ./texture/chim_face.xpm

C 10 ,  10,10

F 30 ,  30,30

        1111111111111111111111111
        1000000000110000000000001
        1011000001110000002000001
        1001000000000000000000001
111111111011000001110000000000001
100000000011000001110111111111111
11110111111111011100000000001
11110111111111011101010010001
11000000110101011100000010001
10000000000000001100000010001
10000000000000001101010010001
1100N00111010101111101111000111
11110111 1212121 101111010001
11111111 1111111 111111111111